10
10
XXXXXXXXXXXXXXXXXXXXXXXXXXXXXXXXXXXXXXXXXXXXXXXXXXX
XsX         X       X     X     X     X         X X
X XXX XXXXX X X XXXXX XXX X X XXX X X X XXXXXXX X X
X     X   X X X X   X X X   X X   X X   X   X     X
XXXXXXX XXX X X X X X X XXXXX X XXX XXXXX X XXXXX X
X       X   X X   X   X X     X   X X     X     X X
XXXXXXX X XXX XXXXXXXXX X XXXXXXX X X XXXXXXXXX XXX
X       X   X X     X   X X     X X X X       X   X
X XXXXX XXX X X X XXX X X X XXX X X X X XXXXX XXX X
X     X X X X X X     X X X X X   X   X     X X   X
X XXX X X X X XXXXXXXXX X X X XXXXXXX XXXXXXX X XXX
X X   X   X X X   X     X       X   X       X X   X
X X XXX XXX X X X X XXX XXXXXXXXX X XXXXXXX X XXX X
X X   X X   X X X   X X X         X     X   X   X X
X XXX XXX XXX X XXXXX X X XXXXXXXXXXXXX X XXXXX X X
X X   X   X     X       X     X       X X       X X
XXX X X XXX XXXXXXXXXXXXXXXXX X XXXXX X XXXXXXXXX X
X   X X X   X   X       X   X X     X           X X
X XXXXX XXXXX X X XXXXX X X X XXX XXXXXXXXXXXXX X X
X   X   X     X   X   X X X X   X X   X     X     X
X X X XXX XXXXXXXXX XXX X X XXX XXX X X XXX XXXXX X
X X X   X X         X   X X     X   X   X X     X X
X X XXX X X XXXXX XXX XXX XXXXX X XXXXXXX XXXXX X X
X X   X   X X   X     X       X X   X       X   X X
XXXXX XXXXX XXX XXXXXXXXX XXX XXXXX XXX XXXXX XXX X
X       X X             X X X     X     X     X X X
X XXXXX X XXXXXXXXXXXXX X X XXXXX XXX XXX XXXXX X X
X     X       X   X   X X   X     X   X   X       X
X XXX XXXXXXXXX X X X X XXX X XXXXX XXX XXXXXXX XXX
X X X   X     X X   X   X X X       X X   X   X   X
X X XXX X XXX X XXXXXXXXX X XXXXXXXXX XXX X X XXXXX
X   X X   X X X   X       X       X     X X X     X
XXX X XXXXX X XXX X XXXXX XXXXXXX XXX X X X XXXXX X
X   X       X   X X   X         X X   X X   X   X X
X XXX XXXXX X XXX XXX X XXX XXXXX X XXX XXXXX X X X
X     X X   X   X X   X X X X   X   X         X X X
XXXXXXX X XXXXX X X XXX X X X X X XXXXXXXXXXXXXXX X
X X   X   X     X X   X X   X X   X         X   X X
X X X X XXX XXX X X XXX X XXX XXXXX XXXXXXX X X X X
X   X   X X X   X X X   X   X     X     X X   X X X
X XXXXXXX X XXXXX X X XXXXX XXXXX XXXXX X XXXXX X X
X       X X       X X     X X     X   X X         X
XXXXXXX X XXXXXXXXXXXXX X XXX XXXXX X X XXXXXXXXXXX
X     X   X       X   X X X         X X           X
XXX X XXX X XXXXX X X X X X XXXXXXXXXXXXXXX XXXXX X
X   X   X X     X   X X X   X         X   X     X X
X X XXXXX X XXX XXXXX XXXXXXX XXXXXXX X X XXXXX X X
X X X   X X X   X   X X     X       X X X X   X X X
X XXX X X XXX XXX XXX X XXX XXXXXXX X X X X X XXX X
X     X       X         X           X   X   X    eX
XXXXXXXXXXXXXXXXXXXXXXXXXXXXXXXXXXXXXXXXXXXXXXXXXXX